Project1
An Interactive Fiction by Kayln B
Release 1 / Serial number 250910 / Inform 7 v10.1.2 / D

Bedroom
It looks very cozy and relaxing, north is the living and east is bathroom.

You can see Chair here.

>check chair
An old rocking chair that was given by your grandmother.

* * *

Project1
An Interactive Fiction by Kayln B
Release 1 / Serial number 250910 / Inform 7 v10.1.2 / D

Bedroom
It looks very cozy and relaxing, north is the living and east is bathroom.

You can see Chair here.

>e chair
I only understood you as far as wanting to (go) east.

>x chair
An old rocking chair that was given by your grandmother.

>e
I'm not going in there.

* * *

Project1
An Interactive Fiction by Kayln B
Release 1 / Serial number 250910 / Inform 7 v10.1.2 / D

Bedroom
It looks very cozy and relaxing, north is the living and east is bathroom.

You can see Chair here.

>n
Living
It only has a couch and rug.

You can see a human here.

I beg your pardon?

>e
Secret room
It very colorful and wacky, there funitures on the walls and ceiling.

You can see Blue here.

>ne
field
There is flowers from many different seasons blooming around.

>take flower
That's hardly portable.

>i
You are carrying nothing.

>x flower
You see nothing special about Flower.

* * *

>n
Living
It only has a couch and rug.

You can see a human here.

>e
Secret room
It very colorful and wacky, there funitures on the walls and ceiling.

You can see Blue here.

>examine blue
You see nothing special about Blue.

* * *

>e
Secret room
It very colorful and wacky, there funitures on the walls and ceiling.

You can see Blue here.

>ne
field
There is flowers from many different seasons blooming around.

You can see Flower here.

>take flower
That's hardly portable.

>pick flower
I didn't understand that sentence.

* * *

>take flower
That's hardly portable.

>take flower
That's hardly portable.

* * *

>ne
field
There is flowers from many different seasons blooming around.

You can see Flower here.

>take key
Taken.

>at random
That's not a verb I recognise.

>random
[Random number generator now predictable.]

* * *

>ne
field
There is flowers from many different seasons blooming around.

You can see Flower here.

>x flower
The flower sinks to the ground and a key appears

>take key
Taken.

>x key
You see nothing special about Key.

* * *

>e
Secret room
It very colorful and wacky, there funitures on the walls and ceiling.

You can see Blue here.

>talk
That's not a verb I recognise.

>talk to blue
That's not a verb I recognise.

>x blue
their blue, but look like a jesture.

* * *

>e
Secret room
It very colorful and wacky, there funitures on the walls and ceiling.

You can see Blue here.

>talk to blue
"Find my pages" Blue says.

* * *

>e
Secret room
It very colorful and wacky, there funitures on the walls and ceiling.

You can see Blue here.

>tell Blue
I didn't understand that sentence.

>talk to Blue
That's not a verb I recognise.

* * *

>n
Living
It only has a couch and rug.

You can see a human here.

>eat
(the human)
THAT A LIVING PERSON?!

>talk to human
That's not a verb I recognise.

>talk human
That's not a verb I recognise.

>talk
That's not a verb I recognise.

* * *

>n
Living
It only has a couch and rug.

You can see a human here.

>eat human
That's plainly inedible.

* * *

>n
Living
It only has a couch and rug.

You can see a human here.

>examine apple
You see nothing special about apple.

>eat apple
That's plainly inedible.

* * *

>n
Living
It only has a couch and rug.

You can see a human here.

>examine human
it a living being.

>eat human
That's plainly inedible.

* * *

>n
Living
It only has a couch and rug.

You can see a human here.

>go norht
You can't see any such thing.

>go north
it sucks.

* * *

>n
Living
It only has a couch and rug.

You can see a human here.

>move couch
It is fixed in place.

* * *

>n
Living
It only has a couch and rug.

You can see a human here.

>ne
You can't go that way.

>e
Secret room
It very colorful and wacky, there funitures on the walls and ceiling.

You can see Blue here.

* * *

>n
Living
It only has a couch and rug.

You can see a human here.

>s
Bedroom
It looks very cozy and relaxing, north is the living and east is bathroom.

You can see apple here.

>e
it sucks.

* * *

Project1
An Interactive Fiction by Kayln B
Release 1 / Serial number 250910 / Inform 7 v10.1.2 / D

Bedroom
It looks very cozy and relaxing, north is the living and east is bathroom.

You can see Chair here.

>take flower
You can't see any such thing.

* * *

Project1
An Interactive Fiction by Kayln B
Release 1 / Serial number 250910 / Inform 7 v10.1.2 / D

Bedroom
It looks very cozy and relaxing, north is the living and east is bathroom.

You can see Chair here.

>talk
Who yourself?

>talk to Blue
I only understood you as far as wanting to talk.

>n
Living
It only has a couch and rug.

You can see a human here.

* * *

>e
Secret room
It very colorful and wacky, there funitures on the walls and ceiling.

You can see Blue here.

>ne
field
There is flowers from many different seasons blooming around.

You can see Key here.

>se
You can't go that way.

>sw
Secret room
It very colorful and wacky, there funitures on the walls and ceiling.

You can see Blue here.

>talk to Blue
I only understood you as far as wanting to talk.

* * *

Project1
An Interactive Fiction by Kayln B
Release 1 / Serial number 250910 / Inform 7 v10.1.2 / D

Bedroom
It looks very cozy and relaxing, north is the living and east is bathroom.

You can see Chair here.

>talk to blue
Who yourself?

>n
Living
It only has a couch and rug.

You can see a human here.

* * *

>e
Secret room
It very colorful and wacky, there funitures on the walls and ceiling.

You can see Blue here.

>talk to blue
You find it impossible to choose from among the hundreds of tempting colors.

* * *

Project1
An Interactive Fiction by Kayln B
Release 1 / Serial number 250910 / Inform 7 v10.1.2 / D

Bedroom
It looks very cozy and relaxing, north is the living and east is bathroom.

You can see Chair here.

>x bedroom
You can't see any such thing.

* * *

Project1
An Interactive Fiction by Kayln B
Release 1 / Serial number 250910 / Inform 7 v10.1.2 / D

Bedroom
It looks very cozy and relaxing, north is the living and east is bathroom.

You can see Chair here.

>x chair
The paint chipping, the chair instantly fell apart.

>n
Living
It only has a couch.

You can see a human here.

>move couch
You can't see any such thing.

* * *

>x chair
The paint chipping, the chair instantly fell apart.

>x chair
You can't see any such thing.

* * *

Project1
An Interactive Fiction by Kayln B
Release 1 / Serial number 250910 / Inform 7 v10.1.2 / D

Bedroom
It looks very cozy and relaxing, north is the living and east is bathroom.

You can see Chair here.

>x key
You can't see any such thing.

>n
Living
It only has a couch and rug.

You can see a human here.

* * *

>ne
field
There is flowers from many different seasons blooming around.

You can see Flower here.

>x key
You can't see any such thing.

>x flower
The flower sinks to the ground and a key appears

>x key
it not a page.

>take key
Taken.

>x key
it not a page.