Welcome try to escape your lovely home. There is HINTS available for you!

Escape Normal House
An Interactive Fiction by Kaz
Release 1 / Serial number 251006 / Inform 7 v10.1.2 / D

Bedroom
It looks very cozy and relaxing, north is the living and east is bathroom.

You can see Chair here.

>check chair
An old rocking chair that was given by your grandmother.

* * *

Welcome try to escape your lovely home. There is HINTS available for you!

Escape Normal House
An Interactive Fiction by Kaz
Release 1 / Serial number 251006 / Inform 7 v10.1.2 / D

Bedroom
It looks very cozy and relaxing, north is the living and east is bathroom.

You can see Chair here.

>e
That the bathroom, you aren't not going in there.

>n
Living
It only has a couch and rug.

You can see a human here.

>eat human
THAT A LIVING PERSON?!

>eat human
THAT A LIVING PERSON?!

>move couch
It is fixed in place.

* * *

Welcome try to escape your lovely home. There is HINTS available for you!

Escape Normal House
An Interactive Fiction by Kaz
Release 1 / Serial number 251006 / Inform 7 v10.1.2 / D

Bedroom
It looks very cozy and relaxing, north is the living and east is bathroom.

You can see Chair here.

>e chair
I only understood you as far as wanting to (go) east.

>x chair
An old rocking chair that was given by your grandmother.

>e
I'm not going in there.

* * *

Welcome try to escape your lovely home. There is HINTS available for you!

Escape Normal House
An Interactive Fiction by Kaz
Release 1 / Serial number 251006 / Inform 7 v10.1.2 / D

Bedroom
It looks very cozy and relaxing, north is the living and east is bathroom.

You can see Chair here.

>hint
Maybe you should leave the bedroom.

>e
That the bathroom, you aren't not going in there.

>n
Living
 It only has a couch, rug, and a bookcase. The Dining room is to the west. 

You can see a bookcase, Couch and a human here.

>hint
I think the a secret here, but look around the house.

>talk to human
I only understood you as far as wanting to talk.

>talk
You try to talk to the stranger in the living room, but the stranger started to maul you like a dog once to said "who"

    *** You got eatten. ***

Would you like to RESTART, RESTORE a saved game, QUIT or UNDO the last command?

>restart
Welcome to a fun exploration of a place call home. There is HINTS available for you!

Project1
An Interactive Fiction by Kayln B
Release 1 / Serial number 251001 / Inform 7 v10.1.2 / D

Bedroom
It looks very cozy and relaxing, north is the living and east is bathroom.

You can see Chair here.

>n
Living
 It only has a couch, rug, and a bookcase. The Dining room is to the west. 

You can see a bookcase, Couch and a human here.

>w
Dining Room
 There a long table in the middle, with pictures around. 

You can see an inconspicuous control panel here.

>hint
You should switch that panel.

>switch panel
You hear a sound of an heavy object moving in the living room. You look out into the living room to see a secret door is opened.

>e
Living
 There a secret room at the east of living room.

You can see a bookcase, Couch and a human here.

>e
Secret room
It a wacky world, there an opening to the northeast side.

You can see a bookcase, Stapler and Blue here.

>talk
"Find my pages" Blue says.

>hint
Talk to that person.

>ne
field
There is flowers from many different seasons blooming around.

You can see Flower and Paper here.

>hint
find what Blue wants.

>take paper
Taken.

>x paper
the paper has writing on it saying, "du hast"

>take flower
Taken.

>x flower
You drop the flower and it sink to the ground and a key appears

>take key
Taken.

>nw
You can't go that way.

>se
You can't go that way.

>sw
Secret room
It a wacky world, there an opening to the northeast side.

You can see a bookcase, Stapler and Blue here.

>give paper
Blue stares at you in the eye before saying "I don't want that..."

>give key
"Thankz loser, now get me a snack" Blue says.

>w
Living
 There a secret room at the east of living room.

You can see a bookcase, Couch and a human here.

>w
Dining Room
 The kitchen is to the south.

You can see an inconspicuous control panel here.

>s
Kitchen
It looks like a rich person kitchen.

You can see Ramen packet, Soup can, Crackers, a single cookie, a wine bottle and Slice of pizza here.

>hint
open the cabinet to look for food.

* * *

>hint
Maybe you should leave the bedroom.

>n
Living
 It only has a couch, rug, and a bookcase. The Dinning room is to the west. 

You can see a bookcase, Couch and a human here.

* * *

Welcome try to escape your lovely home. There is HINTS available for you!

Escape Normal House
An Interactive Fiction by Kaz
Release 1 / Serial number 251006 / Inform 7 v10.1.2 / D

Bedroom
It looks very cozy and relaxing, north is the living and east is bathroom.

You can see Chair here.

>move
(Chair)
Nothing obvious happens.

>n
Living
It only has a couch and rug.

You can see a human here.

>move couch
It is fixed in place.

* * *

Welcome try to escape your lovely home. There is HINTS available for you!

Escape Normal House
An Interactive Fiction by Kaz
Release 1 / Serial number 251006 / Inform 7 v10.1.2 / D

Bedroom
It looks very cozy and relaxing, north is the living and east is bathroom.

You can see Chair here.

>move couch
You can't see any such thing.

>n
Living
It only has a couch and rug.

You can see a human here.

* * *

Welcome try to escape your lovely home. There is HINTS available for you!

Escape Normal House
An Interactive Fiction by Kaz
Release 1 / Serial number 251006 / Inform 7 v10.1.2 / D

Bedroom
It looks very cozy and relaxing, north is the living and east is bathroom.

You can see Chair here.

>n
Living
 It only has a couch, rug, and a bookcase, the front door and windows are missing. The Dining room is to the west. 

You can see a bookcase, Couch and a human here.

I beg your pardon?

>e
Secret room
It very colorful and wacky, there funitures on the walls and ceiling.

You can see Blue here.

>ne
field
There is flowers from many different seasons blooming around.

>take flower
That's hardly portable.

>i
You are carrying nothing.

>x flower
You see nothing special about Flower.

* * *

>n
Living
 It only has a couch, rug, and a bookcase, the front door and windows are missing. The Dining room is to the west. 

You can see a bookcase, Couch and a human here.

>e
Secret room
It a wacky world, there an opening to the northeast side and a blue person.

You can see a bookcase, Blue and a vase (in which is a pile of wacky junk) here.

>attack
What do you want to attack?

>blue
You try to throw a punch at Blue,

    *** Blue pins you down on the ground and punches you over and over again. 
 You died from bleeding out. ***

Would you like to RESTART, RESTORE a saved game, QUIT or UNDO the last command?

* * *

>e
Secret room
It a wacky world, there an opening to the northeast side and a blue person.

You can see a bookcase, Blue and a vase (in which is a pile of wacky junk) here.

>examine blue
You see nothing special about Blue.

* * *

>e
Secret room
It a wacky world, there an opening to the northeast side and a blue person.

You can see a bookcase, Blue and a vase (in which is a pile of wacky junk) here.

>ne
field
There is flowers from many different seasons blooming around, surrounded by unknown locations.

You can see Flower and Paper here.

>e
*** You climb the mountain not caring if your wearing the right footware, you accidently slip off a rock and fell 12 feet from the ground 
 You died falling. 
 Mountain ending 6/7 ***

Would you like to RESTART, RESTORE a saved game, QUIT or UNDO the last command?

>undeo
Please give one of the answers above.

Would you like to RESTART, RESTORE a saved game, QUIT or UNDO the last command?

>undo
field
[Previous turn undone.]

>n
*** You dash straight to the forest getting further away from the room you exit, you stop for a moment to breath not knowing a big tree collapse on top of you, the only thing you saw was the field before being crushed 
 You died from a tree falling on you. 
 Quiet Tree ending 3/7 ***

Would you like to RESTART, RESTORE a saved game, QUIT or UNDO the last command?

>undo
field
[Previous turn undone.]

>s
*** You run to the house not knowing there a person inside, when the person saw you running straight towards you they kicked the door open and shot you point blank in the head 
 You died from getting shot at. 
 Fool ending 7/7 ***

Would you like to RESTART, RESTORE a saved game, QUIT or UNDO the last command?

* * *

>ne
field
There is flowers from many different seasons blooming around, surrounded by unknown locations.

You can see Flower and Paper here.

>n
*** You dash straight to the forest getting further away from the room you exit, you stop for a moment to breath not knowing a big tree collapse on top of you, the only thing you saw was the field before being crushed 
 You died from a tree falling on you. ***

Would you like to RESTART, RESTORE a saved game, QUIT or UNDO the last command?

* * *

>ne
field
There is flowers from many different seasons blooming around, surrounded by unknown locations.

You can see Flower and Paper here.

>take flower
That's hardly portable.

>pick flower
I didn't understand that sentence.

* * *

>take flower
That's hardly portable.

>take flower
That's hardly portable.

* * *

>ne
field
There is flowers from many different seasons blooming around, surrounded by unknown locations.

You can see Flower and Paper here.

>take key
Taken.

>at random
That's not a verb I recognise.

>random
[Random number generator now predictable.]

* * *

>ne
field
There is flowers from many different seasons blooming around, surrounded by unknown locations.

You can see Flower and Paper here.

>x field
You can't see any such thing.

>x room
You can't see any such thing.

>x location
You can't see any such thing.

>x the field
You can't see any such thing.

* * *

>ne
field
There is flowers from many different seasons blooming around, surrounded by unknown locations.

You can see Flower and Paper here.

>x flower
The flower sinks to the ground and a key appears

>take key
Taken.

>x key
You see nothing special about Key.

* * *

>e
Secret room
It a wacky world, there an opening to the northeast side and a blue person.

You can see a bookcase, Blue and a vase (in which is a pile of wacky junk) here.

>s
You can't go that way.

>w
Living
 There a secret room at the east of living room.

You can see a bookcase, Couch and a human here.

>e
Secret room
It a wacky world, there an opening to the northeast side.

You can see a bookcase, Stapler and Blue here.

>take stapler
Taken.

>five stapler
That's not a verb I recognise.

>give stapler
"Why..." Blue says.

* * *

>e
Secret room
It a wacky world, there an opening to the northeast side and a blue person.

You can see a bookcase, Blue and a vase (in which is a pile of wacky junk) here.

>talk
That's not a verb I recognise.

>talk to blue
That's not a verb I recognise.

>x blue
their blue, but look like a jesture.

* * *

>e
Secret room
It a wacky world, there an opening to the northeast side and a blue person.

You can see a bookcase, Blue and a vase (in which is a pile of wacky junk) here.

>talk to blue
"Hey can you find my item?" Blue says. 
 "What item?" you ask. 
 "Just give it to me..." Blue reply annoyed.

* * *

>e
Secret room
It a wacky world, there an opening to the northeast side and a blue person.

You can see a bookcase, Blue and a vase (in which is a pile of wacky junk) here.

>tell Blue
I didn't understand that sentence.

>talk to Blue
That's not a verb I recognise.

* * *

>e
Secret room
It a wacky world, there an opening to the northeast side and a blue person.

You can see a bookcase, Blue and a vase (in which is a pile of wacky junk) here.

>x vase
It's just a vase  that apperently full of random object you don't know if you can explain. There's so much stuff that almost anything might be buried down there.

In the vase is a pile of wacky junk.

>search vase
Down among the wacky junk, you spot a stapler!

>search junk
You find nothing of interest.

>x vase
It's just a vase.

In the vase are a pile of wacky junk and now the stapler.

* * *

>search vase
Down among the wacky junk, you spot a stapler!

>search vase
In the vase is a pile of wacky junk.

>search vase
In the vase is a pile of wacky junk.

>x vase
It's just a vase.

In the vase is a pile of wacky junk.

>take junk
You are to afraid to touch any of that.

>search vase
In the vase is a pile of wacky junk.

* * *

>x vase
It's just a vase.

In the vase is a pile of wacky junk.

>search vase
In the vase is a pile of wacky junk.

>look in vase
In the vase is a pile of wacky junk.

>x vase
It's just a vase.

In the vase is a pile of wacky junk.

* * *

>search vase
Down among the wacky junk, you spot a stapler!

>take junk
You have no need to burden yourself with a pile of old junk.

>searching junk
That's not a verb I recognise.

>search junk
Down among the rusty junk, you spot a priceless jewel-encrusted bracelet!

* * *

>search vase
Down among the wacky junk, you spot a stapler!

>take stapler
Taken.

>give stapler
Blue stares at you in the eye before saying "I don't want that..." 
 "But this is the item you want?" you explain. 
 "No" Blue stated before throwing the nothing at your head.

* * *

>x vase
It's just a vase  that apperently full of random object you don't know if you can explain. There's so much stuff that almost anything might be buried down there.

In the vase is a pile of wacky junk.

>x vase
It's just a vase .

In the vase is a pile of wacky junk.

>search vase
Down among the wacky junk, you spot a stapler!

* * *

>take stapler
Taken.

>i
You are carrying:
  Stapler

* * *

>n
Living
 It only has a couch, rug, and a bookcase, the front door and windows are missing. The Dining room is to the west. 

You can see a bookcase, Couch and a human here.

>eat
(the human)
THAT A LIVING PERSON?!

>talk to human
That's not a verb I recognise.

>talk human
That's not a verb I recognise.

>talk
That's not a verb I recognise.

* * *

>n
Living
 It only has a couch, rug, and a bookcase, the front door and windows are missing. The Dining room is to the west. 

You can see a bookcase, Couch and a human here.

>eat human
That's plainly inedible.

* * *

>n
Living
 It only has a couch, rug, and a bookcase, the front door and windows are missing. The Dining room is to the west. 

You can see a bookcase, Couch and a human here.

>examine apple
You see nothing special about apple.

>eat apple
That's plainly inedible.

* * *

>n
Living
 It only has a couch, rug, and a bookcase, the front door and windows are missing. The Dining room is to the west. 

You can see a bookcase, Couch and a human here.

>examine human
it a living being.

>eat human
That's plainly inedible.

* * *

>n
Living
 It only has a couch, rug, and a bookcase, the front door and windows are missing. The Dining room is to the west. 

You can see a bookcase, Couch and a human here.

>go norht
You can't see any such thing.

>go north
it sucks.

* * *

>n
Living
 It only has a couch, rug, and a bookcase, the front door and windows are missing. The Dining room is to the west. 

You can see a bookcase, Couch and a human here.

>move couch
Nothing obvious happens.

>examine couch
You see nothing special about Couch.

* * *

>move couch
Nothing obvious happens.

>move the couch
Nothing obvious happens.

>move the couch
It is fixed in place.

* * *

>move couch
Nothing obvious happens.

>push couch
Nothing obvious happens.

>push the couch
Nothing obvious happens.

* * *

>n
Living
 It only has a couch, rug, and a bookcase, the front door and windows are missing. The Dining room is to the west. 

You can see a bookcase, Couch and a human here.

>move rug
It is fixed in place.

>move couch
Nothing obvious happens.

* * *

>move the couch
Nothing obvious happens.

>moving the couch
I only understood you as far as wanting to moving.

* * *

>n
Living
 It only has a couch, rug, and a bookcase, the front door and windows are missing. The Dining room is to the west. 

You can see a bookcase, Couch and a human here.

>move the couch
Nothing obvious happens.

* * *

>n
Living
 It only has a couch, rug, and a bookcase, the front door and windows are missing. The Dining room is to the west. 

You can see a bookcase, Couch and a human here.

>ne
You can't go that way.

>e
Secret room
It a wacky world, there an opening to the northeast side.

You can see a bookcase, Stapler and Blue here.

>ne
field
There is flowers from many different seasons blooming around.

* * *

>n
Living
 It only has a couch, rug, and a bookcase, the front door and windows are missing. The Dining room is to the west. 

You can see a bookcase, Couch and a human here.

>push couch
Nothing obvious happens.

I beg your pardon?

* * *

>n
Living
 It only has a couch, rug, and a bookcase, the front door and windows are missing. The Dining room is to the west. 

You can see a bookcase, Couch and a human here.

>push the couch
Nothing obvious happens.

>w
Dinning
There a long table in the middle, with pictures around.

You can see Long table and an inconspicuous control panel here.

>switch panel
You hear a sound of an heavy object moving in the living room. You look out into the living room to see a secret door is opened.

* * *

>n
Living
 It only has a couch, rug, and a bookcase, the front door and windows are missing. The Dining room is to the west. 

You can see a bookcase, Couch and a human here.

>s
Bedroom
It looks very cozy and relaxing, north is the living and east is bathroom.

You can see apple here.

>e
it sucks.

* * *

>n
Living
 It only has a couch, rug, and a bookcase, the front door and windows are missing. The Dining room is to the west. 

You can see a bookcase, Couch and a human here.

>talk
You try to talk to the stranger in the living room, but the stranger started to maul you like a dog once to said "who"

    *** You got eatten. 
 ending 4/6 ***

Would you like to RESTART, RESTORE a saved game, QUIT or UNDO the last command?

>restart
Welcome to a fun exploration of a place call home.

Project1
An Interactive Fiction by Kayln B
Release 1 / Serial number 250924 / Inform 7 v10.1.2 / D

Bedroom
It looks very cozy and relaxing, north is the living and east is bathroom.

You can see Chair here.

* * *

>talk
You try to talk to the stranger in the living room, but the stranger started to maul you like a dog once to said "who"

    *** You got eatten. 
 ending 4/6 ***

Would you like to RESTART, RESTORE a saved game, QUIT or UNDO the last command?

>talking
That's not a verb I recognise.

>talk
Who yourself?

>w
Dinning
There a long table in the middle, with pictures around.

You can see Long table and an inconspicuous control panel here.

>e
Living
 There a secret room at the east of living room.

You can see a bookcase, Couch and a human here.

>talk to human
I only understood you as far as wanting to talk.

* * *

>n
Living
 It only has a couch, rug, and a bookcase, the front door and windows are missing. The Dining room is to the west. 

You can see a bookcase, Couch and a human here.

>w
Dining Room
 There a long table in the middle, with pictures around. 

You can see an inconspicuous control panel here.

>e
Living
 There a secret room at the east of living room.

You can see a bookcase, Couch and a human here.

>examine human
it a living being.

>examine
What do you want to examine?

>examine bookcase
It filled with a bunch of books you've never read.

>talk to human
I only understood you as far as wanting to talk.

>w
Dining Room
 The kitchen is to the south.

You can see an inconspicuous control panel here.

>examine control panel
The inconspicuous control panel is currently switched off.

>turn on control panel
You hear a sound of an heavy object moving in the living room. You look out into the living room to see a secret door is opened.

>e
Living
 There a secret room at the east of living room.

You can see a bookcase, Couch and a human here.

>examine bookcase
It filled with a bunch of books you've never read.

>examine door
You can't see any such thing.

>examine secret room
You can't see any such thing.

>e
Secret room
It a wacky world, there an opening to the northeast side.

You can see a bookcase, Stapler and Blue here.

>ne
field
There is flowers from many different seasons blooming around, surrounded by unknown locations.

You can see Flower and Paper here.

>take flower
Taken.

>take paper
Taken.

>sw
Secret room
It a wacky world, there an opening to the northeast side.

You can see a bookcase, Stapler and Blue here.

>take stapler
Taken.

>w
Living
 There a secret room at the east of living room.

You can see a bookcase, Couch and a human here.

>examine himan
You can't see any such thing.

>examine human
it a living being.

>give human flower
You can only do that to something animate.

>talk to blue
You try to talk to the stranger in the living room, but the stranger started to maul you like a dog once to said "who"

    *** You got eatten. ***

Would you like to RESTART, RESTORE a saved game, QUIT or UNDO the last command?

>Restart
Welcome try to escape your lovely home. There is HINTS available for you!

Project1
An Interactive Fiction by Kayln B
Release 1 / Serial number 251001 / Inform 7 v10.1.2 / D

Bedroom
It looks very cozy and relaxing, north is the living and east is bathroom.

You can see Chair here.

>north
Living
 It only has a couch, rug, and a bookcase, the front door and windows are missing. The Dining room is to the west. 

You can see a bookcase, Couch and a human here.

>w
Dining Room
 There a long table in the middle, with pictures around. 

You can see an inconspicuous control panel here.

>turn on control panel
You hear a sound of an heavy object moving in the living room. You look out into the living room to see a secret door is opened.

>living room
That's not a verb I recognise.

>e
Living
 There a secret room at the east of living room.

You can see a bookcase, Couch and a human here.

>examine secret door
You can't see any such thing.

>e
Secret room
It a wacky world, there an opening to the northeast side.

You can see a bookcase, Stapler and Blue here.

>talk to blue
"Find my pages" Blue says.

* * *

>e
Living
 There a secret room at the east of living room.

You can see a bookcase, Couch and a human here.

>w
Dining Room
 The kitchen is to the south.

You can see an inconspicuous control panel here.

* * *

>s
Kitchen
It looks like a rich person kitchen.

You can see Ramen packet, Soup can, Crackers, a single cookie, a wine bottle and Slice of pizza here.

>hint
There a lot of food here, but choose carefully one can be a trap.

>take soup
You grasp the Soup can from the counter.

    *** Soup can was covered in poison, one touch and your dead. ***

Would you like to RESTART, RESTORE a saved game, QUIT or UNDO the last command?

* * *

>s
Kitchen
It looks like a rich person kitchen.

You can see Ramen packet, Soup can, Crackers, a single cookie, a wine bottle and Slice of pizza here.

>n
You can't go that way.

>e
Living
 There a secret room at the east of living room.

You can see a bookcase, Couch and a human here.

* * *

>w
Dining Room
 There a long table in the middle, with pictures around. 

You can see an inconspicuous control panel here.

>press switch
You can't see any such thing.

>x swtich
You can't see any such thing.

>x switch
You can't see any such thing.

>press switch
You can't see any such thing.

>take switch
You can't see any such thing.

>press panel
Nothing obvious happens.

>turn panel on
You hear a sound of an heavy object moving in the living room. You look out into the living room to see a secret door is opened.

>n
You can't go that way.

>e
Living
It only has a couch, rug, and a bookcase. The Dinning room is to the west

You can see a bookcase, Couch and a human here.

>x bookcase
It filled with a bunch of books you've never read.

* * *

>w
Dining Room
 There a long table in the middle, with pictures around. 

You can see an inconspicuous control panel here.

>s
Kitchen
It looks like a rich person kitchen.

You can see Ramen packet, Soup can, Crackers, a single cookie, a wine bottle and Slice of pizza here.

>take ramen packet
You grasp the Ramen packet from the dusty floor.

    *** You got eatten. ***

Would you like to RESTART, RESTORE a saved game, QUIT or UNDO the last command?

>take
What do you want to take?

>ramen packet
You can't see any such thing.

>x kitchen
You can't see any such thing.

>examine kitchen
You can't see any such thing.

* * *

>s
Kitchen
It looks like a rich person kitchen.

You can see Ramen packet, Soup can, Crackers, a single cookie, a wine bottle and Slice of pizza here.

>x
What do you want to examine?

>location
You can't see any such thing.

>x kitchen
You can't see any such thing.

>x room
You can't see any such thing.

* * *

>s
Kitchen
It looks like a rich person kitchen.

You can see Ramen packet, Soup can, Crackers, a single cookie, a wine bottle and Slice of pizza here.

>x ramen packet
It in packaging but you think Blue will eat it anyways.

>x soup can
You should heat it up but Blue will eat it no matter what.

>x crackers
It a box of very salty crackers.

>x single cookie
There rasins in it, at least you believe it rasins.

>x wine bottle
It liquid but Blue will eat it.

>x slice of pizza
It a week old but it still good.

>take slice of pizza
You grasp the Slice of pizza from the counter.

    *** Slice of pizza was covered in poison, one touch and your dead. ***

Would you like to RESTART, RESTORE a saved game, QUIT or UNDO the last command?

* * *

>w
Dining Room
 There a long table in the middle, with pictures around. 

You can see an inconspicuous control panel here.

>switch panel
You hear a sound of an heavy object moving in the living room. You look out into the living room to see a secret door is opened.

>e
Living
 There a secret room at the east of living room

You can see a bookcase, Couch and a human here.

>e
Secret room
You can see a bookcase and Blue here.

* * *

>switch panel
You hear a sound of an heavy object moving in the living room. You look out into the living room to see a secret door is opened.

>w
You can't go that way.

>e
Living
 There a secret room at the east of living room.

You can see a bookcase, Couch and a human here.

* * *

>take stapler
Taken.

>give stapler to Blue
"Thankz loser" Blue says.

* * *

>w
Dining Room
 There a long table in the middle, with pictures around. 

You can see an inconspicuous control panel here.

>swtich panel
That's not a verb I recognise.

>switch panel
You hear a sound of an heavy object moving in the living room. You look out into the living room to see a secret door is opened.

* * *

>e
Living
 There a secret room at the east of living room.

You can see a bookcase, Couch and a human here.

>e
Secret room
It a wacky world.

You can see a bookcase and Blue here.

>talk to blue
"Find my pages" Blue says.

* * *

>w
Dining Room
 There a long table in the middle, with pictures around. 

You can see an inconspicuous control panel here.

>w
You can't go that way.

* * *

>e
Living
 There a secret room at the east of living room.

You can see a bookcase, Couch and a human here.

>ne
You can't go that way.

* * *

>e
Secret room
It a wacky world, there an opening to the northeast side.

You can see a bookcase, Stapler and Blue here.

>ne
field
There is flowers from many different seasons blooming around.

You can see Flower and Paper here.

>take flower
Taken.

>examine flower
The flower sinks to the ground and a key appears

>take key
Taken.

* * *

>w
Dining Room
 There a long table in the middle, with pictures around. 

You can see an inconspicuous control panel here.

>x control panel
The inconspicuous control panel is currently switched off.

>switch control panel
One of the bookcases slides upward, revealing a passage to the east!

* * *

>n
Living
 It only has a couch, rug, and a bookcase, the front door and windows are missing. The Dining room is to the west. 

You can see a bookcase, Couch and a human here.

>x bookcase
It filled with a bunch of books you've never read.

>w
Dinning
There a long table in the middle, with pictures around.

You can see Long table and an inconspicuous control panel here.

>x long table
you look around the table for no reason, as you crouch you saw a control panel.

* * *

>n
Living
 It only has a couch, rug, and a bookcase, the front door and windows are missing. The Dining room is to the west. 

You can see a bookcase, Couch and a human here.

>x couch
you could probably move it if you try.

>move couch
Nothing obvious happens.

* * *

>x couch
you could probably move it if you try.

>push couch
Nothing obvious happens.

* * *

>n
Living
 It only has a couch, rug, and a bookcase, the front door and windows are missing. The Dining room is to the west. 

You can see a bookcase, Couch and a human here.

>x human
it a living being.

>eat human
THAT A LIVING PERSON?!

* * *

>n
Living
 It only has a couch, rug, and a bookcase, the front door and windows are missing. The Dining room is to the west. 

You can see a bookcase, Couch and a human here.

>x rug
you could move it if you want, but if you do, dirt will go everywhere.

>x couch
you could probably move it if you try.

* * *

>n
Living
 It only has a couch, rug, and a bookcase, the front door and windows are missing. The Dining room is to the west. 

You can see a bookcase, Couch and a human here.

>xc
That's not a verb I recognise.

>x couch
you could probably move it if you try.

>move couch
It is fixed in place.

>push couch
It is fixed in place.

* * *

Welcome try to escape your lovely home. There is HINTS available for you!

Escape Normal House
An Interactive Fiction by Kaz
Release 1 / Serial number 251006 / Inform 7 v10.1.2 / D

Bedroom
It looks very cozy and relaxing, north is the living and east is bathroom.

You can see Chair here.

>take flower
You can't see any such thing.

* * *

Welcome try to escape your lovely home. There is HINTS available for you!

Escape Normal House
An Interactive Fiction by Kaz
Release 1 / Serial number 251006 / Inform 7 v10.1.2 / D

Bedroom
It looks very cozy and relaxing, north is the living and east is bathroom.

You can see Chair here.

>talk
Who yourself?

>talk to Blue
I only understood you as far as wanting to talk.

>n
Living
It only has a couch and rug.

You can see a human here.

>e
Secret room
It very colorful and wacky, there funitures on the walls and ceiling.

You can see Blue here.

>ne
field
There is flowers from many different seasons blooming around.

You can see Key here.

>se
You can't go that way.

>sw
Secret room
It very colorful and wacky, there funitures on the walls and ceiling.

You can see Blue here.

>talk to Blue
I only understood you as far as wanting to talk.

* * *

Welcome try to escape your lovely home. There is HINTS available for you!

Escape Normal House
An Interactive Fiction by Kaz
Release 1 / Serial number 251006 / Inform 7 v10.1.2 / D

Bedroom
It looks very cozy and relaxing, north is the living and east is bathroom.

You can see Chair here.

>talk to blue
Who yourself?

>n
Living
It only has a couch and rug.

You can see a human here.

>ne
You can't go that way.

>e
Secret room
It very colorful and wacky, there funitures on the walls and ceiling.

You can see Blue here.

>talk to blue
You find it impossible to choose from among the hundreds of tempting colors.

* * *

Welcome try to escape your lovely home. There is HINTS available for you!

Escape Normal House
An Interactive Fiction by Kaz
Release 1 / Serial number 251006 / Inform 7 v10.1.2 / D

Bedroom
It looks very cozy and relaxing, north is the living and east is bathroom.

You can see Chair here.

>x
(Chair)
An old rocking chair that was given by your grandmother.

>x the room
You can't see any such thing.

>x room
You can't see any such thing.

>x the room
You can't see any such thing.

* * *

Welcome try to escape your lovely home. There is HINTS available for you!

Escape Normal House
An Interactive Fiction by Kaz
Release 1 / Serial number 251006 / Inform 7 v10.1.2 / D

Bedroom
It looks very cozy and relaxing, north is the living and east is bathroom.

You can see Chair here.

>x bedroom
You can't see any such thing.

* * *

Welcome try to escape your lovely home. There is HINTS available for you!

Escape Normal House
An Interactive Fiction by Kaz
Release 1 / Serial number 251006 / Inform 7 v10.1.2 / D

Bedroom
It looks very cozy and relaxing, north is the living and east is bathroom.

You can see Chair here.

>x chair
The paint chipping, the chair instantly fell apart.

>n
Living
It only has a couch.

You can see a human here.

>move couch
You can't see any such thing.

* * *

>x chair
The paint chipping, the chair instantly fell apart.

>x chair
You can't see any such thing.

* * *

Welcome try to escape your lovely home. There is HINTS available for you!

Escape Normal House
An Interactive Fiction by Kaz
Release 1 / Serial number 251006 / Inform 7 v10.1.2 / D

Bedroom
It looks very cozy and relaxing, north is the living and east is bathroom.

You can see Chair here.

>x key
You can't see any such thing.

>n
Living
 It only has a couch, rug, and a bookcase. The Dinning room is to the west. 

You can see a bookcase, Couch and a human here.

>e
Secret room
It very colorful and wacky, there funitures on the walls and ceiling.

You can see Blue here.

>ne
field
There is flowers from many different seasons blooming around.

You can see Flower here.

>x key
You can't see any such thing.

>x flower
The flower sinks to the ground and a key appears

>x key
it not a page.

>take key
Taken.

>x key
it not a page.

* * *

>n
Living
 It only has a couch, rug, and a bookcase. The Dinning room is to the west. 

You can see a bookcase, Couch and a human here.

>w
Dinning
There a long table in the middle, with pictures around.

You can see Long table and an inconspicuous control panel here.

* * *

>e
Living
 There a secret room at the east of living room.

You can see a bookcase, Couch and a human here.

>e
Secret room
You can see a bookcase and Blue here.

>talk
"Find my pages" Blue says.

>e
Living
 There a secret room at the east of living room.

You can see a bookcase, Couch and a human here.

* * *

>e
Secret room
You can see a bookcase and Blue here.

>x secret room
You can't see any such thing.